{
  "a": 0,
  "b": 1,
  "d": 2,
  "e": 3,
  "f": 4,
  "g": 5,
  "h": 6,
  "i": 7,
  "j": 8,
  "k": 9,
  "l": 10,
  "m": 11,
  "n": 12,
  "o": 13,
  "p": 14,
  "r": 15,
  "s": 16,
  "t": 17,
  "u": 18,
  "v": 19,
  "y": 20,
  "z": 21,
  "ʃ": 22,
  "ʒ": 23,
  "ŋ": 24,
  "ø": 25,
  "œ": 26,
  "ɧ": 27,
  "ʉ": 28,
  "ɪ": 29,
  "ɛ": 30,
  "ɑ": 31,
  "ɔ": 32,
  "ʊ": 33,
  "θ": 34,
  "ð": 35,
  "tʃ": 36,
  "dʒ": 37,
  "x": 38,
  "ts": 39,
  "dz": 40,
  "ʔ": 41,
  "ɾ": 42,
  "ɲ": 43,
  "ʎ": 44,
  "ɡ": 45,
  "w": 46,
  "ɫ": 47,
  "ɹ": 48,
  "æ": 49,
  "ə": 50,
  "ɜ": 51,
  "ɐ": 52,
  "ː": 53,
  "ˈ": 54,
  "ˌ": 55,
  "ʰ": 56,
  "ʲ": 57,
  "ʷ": 58,
  "̃": 59,
  "ʝ": 60,
  "ɽ": 61,
  "ɣ": 62,
  "ʋ": 63,
  "ɕ": 64,
  "ʂ": 65,
  "ɤ": 66,
  "ɨ": 67,
  "ɘ": 68,
  "ɞ": 69,
  "ʡ": 70,
  "ʕ": 71,
  "ʐ": 72,
  "ʑ": 73,
  "ɬ": 74,
  "ɮ": 75,
  "ʟ": 76,
  "ʈ": 77,
  "ɳ": 78,
  "ɖ": 79,
  "ʄ": 80,
  "ɭ": 81,
  "ɲ̊": 82,
  "ʙ": 83,
  "ʀ": 84,
  "ɾ̞": 85,
  "ɡ̊": 86,
  "ʘ": 87,
  "ǀ": 88,
  "ǃ": 89,
  "ǂ": 90,
  "ǁ": 91,
  "UNK": 92
}
